20 7
18 0
12 6
XXXXXXXXXXXXXXXXXX X
X     X       XXXX X
X XXXXX XXXXX   XX X
X XXXXX XXXXXXX XX X
X            XX XX X
X XXXXXXXXXX XX    X
XXXXXXXXXXXX XXXXXXX